NO ./textures/walls/w3d_n.xpm
SO ./textures/walls/w3d_s.xpm
WE ./textures/walls/w3d_w.xpm
EA ./textures/walls/w3d_e.xpm

C 63,63,127
F 63,63,63

                            111111111111111
     111111                 100000000000001
     100001      111111111111000000000000011111
     1000011     100000000001000000000000010001
     1000001     100000000000000000000000000001
     1000001     100000000001000000000000010001
     11111011111 100011111111000000000000011111
     10000000001 10001      100000000000001
     1000000000111000111    111111011111111
     1000000000100000001        10001
     1000000000000000001        10001
     1000000000100000001        10001
111111000000000111111111        10001
1000110000000001                10001
1000111111011111           111111000111
10001   10001              100000000001
11011   10001              100111000111
1000111110001              1001 10001
1000100010001              1001 10001
1000000010001              1111 10001
1000100010001                   10001
1000111111011111               1110111               1111111111
1000110000000001          11111100000111111          1000000001
1000110000000001          10000000000000001          1000000001
1000110000000001          1000000000000000111111111111000000001
1000010000000001          1000000000000000010000000001000000001
1000000000000001          1000000000000000000000000000000000001
1000010000000001          1000000000000000010000000001000000001
1000110000000001          1000000000000000111110011111000000001
1000110000000001          10000000000000001   1001   1000000001
1000110000000001          11111100000111111   1001   1000000001
1000111111011111               1110111        1001   1110110111
10001   10001                   10001         1001     111111
1000111110001                   10001         1001
1000100010001                   10001         100111111111111
1000000010001                   10001         100111010101011
1000100010001                   10001         100010000000001
1000111110001                   10001         100000000000001
1000111110001111111111111       10001         100010000000001
100000000000000001000000111     10001         111111010101011
100000000000000000000000001     10001              1111111111
100000000000000001000000111     10001
1111111111111111110111111       10001
         111001000001     11111111011111111
         100001001011     10000010001000001
         11100000111      10000000000000001
           1101111        10000010001000001
            1001          10000010001000001
            1001          11111110001111111
            1111           100001000100001
                           10E000000000001
                           100001000100001
                           111111000111111
                           100000000000001
                           100000000000001
                           100000000000001
                           111111111111111
