NO ./textures/walls/w3d_n.xpm
SO ./textures/walls/w3d_s.xpm
WE ./textures/walls/w3d_w.xpm
EA ./textures/walls/w3d_e.xpm
C 255,255,255
F 0,0,00000000

111111111111111111111111
1000000000110000000000001
1011000001110000000000001
100100000000000000000000111111111
111111111011000001110000000000001
100000000111000001110111111111111
11110111111 11011100000010001
11110111111 11011101010010000
1100000011111101110000001000111111111 1111111
1000000000000001100000011111
1000000000000000110101001000111    1111
110000011101010111110111100111
01110111 1110101 10111101N0001 1111111
11111111 1111111 111111111111