NO ./textures/walls/w3d_n.xpm
SO ./textures/walls/w3d_s.xpm
WE ./textures/walls/w3d_w.xpm
EA ./textures/walls/w3d_e.xpm
C 255,255,255
F 0,0,000000001

111111111111111111111111
1000000000110000000000001
1011000001110000000000001
100100000000000000000000111111111
111111111011000001110000000000001
100000000111000001110111111111111
11110111111 11011100000010001
11110111111 11011101010010000
1100000011111101110000001000111111111 1111111
10000000000000001100000011111
10000000000000001101010010001111    1111
11000001110101011111011110N0111
01110111 1110101 101111010001 1111111
11111111 1111111 111111111111
