NO ./textures/walls/w3d_n.xpm
SO ./textures/walls/w3d_s.xpm
WE ./textures/walls/w3d_w.xpm
EA ./textures/walls/w3d_e.xpm

C 63,63,127
F 63,63,63

11111111111111111
10000010001000001
10000000000000001
10000010001000001
10000010001000001
11111110001111111
 100001000100001
 100000000000001
 100001000100001
 111111000111111
 100000000000001
 100000000000001
 1000N0000000001
 111111111111111