NO ./textures/walls/w3d_n.xpm
SO ./textures/walls/w3d_s.xpm
WE ./textures/walls/w3d_w.xpm
EA ./textures/walls/w3d_e.xpm

C 63,63,127
F 63,63,63

1111111111111111111111111
1010000000100000000000001
1010001110000000111111001
1000001010000000100001001
1000000N00100000000001001
1111111111111111111111111
