NO ./textures/walls/w3d_n.xpm
SO ./textures/walls/w3d_s.xpm
WE ./textures/walls/w3d_w.xpm
EA ./textures/walls/w3d_e.xpm
C 255,255,255
F 0,0,00000000

11111
10001
10W01
10001 1
11111
111