NO ./textures/walls/w3d_n.xpm
SO ./textures/walls/w3d_s.xpm
WE ./textures/walls/w3d_w.xpm
EA ./textures/walls/w3d_e.xpm

C 63,63,127
F 63,63,63

        1111111111111111111111111
        1000000000110000000000001
        10110000011100000000000N1
        1001000000000000000000001
111111111011000001110000000000001
100000000011000001110111111111111
11110111111111011100000010001
11110111111111011101010010001111
11000000110101011100000010001
1000000000000000110000001000111
10000000000000001101010000001
110000011101010111110111100011
11110111 1110101 101111010001
11111111 1111111 111111111111
