NO ./textures/walls/w3d_n.xpm
SO ./textures/walls/w3d_s.xpm
WE ./textures/walls/w3d_w.xpm
EA ./textures/walls/w3d_e.xpm

C 63,63,127
F 63,63,63

11111
10001
1E001
11111
