NO ./textures/walls/w3d_n.xpm
SO ./textures/walls/w3d_s.xpm
WE ./textures/walls/w3d_w.xpm
EA ./textures/walls/w3d_e.xpm
C 255,255,255
F 0,0,00000000

                  1111111111111111111111111
                  1000000000110000000000001
                  1011000001110000000000001
                  100100000000000000000000111111111
        111111111111111111011000001110000000000001
                  100000000111000001110111111111111
                  1111011111 1111011100000010001
                  11110111111 110111010100100011
                  1100000011111101110000001000111111111 111111
                  10000000000000011000000111111
                  1000000000000000110101001000111    1111
                  1100000111010101111101111N0111
                  11110111 1110101 101111001001 1111 111
                  11111111 1111111 111111111111
