NO ./textures/walls/w3d_n.xpm
SO ./textures/walls/w3d_s.xpm
WE ./textures/walls/w3d_w.xpm
EA ./textures/walls/w3d_e.xpm


  
C     0,0,42
F     0,0,12


                                                                                          
                                                                                            





 

                                           11
                                          11111
                                          110111
                                         11000111
                                       111000000111
                                 1111111000000111111111
                                  110000000000E0000011
                                   1100000000000000011
                                   11000000000000011
                                    1110000111000011
                                      110011 110011
                                      110111  111011
                                     110111    111011
                                    110111      111011
                                   11111         10111
                                  111111         11111
